111111111111111111111111111111111
100000000000000000000000000000001
101101101110110110000000000000001
100000000000000000000000000000001
111011011011011011000000000000001
1PCCC000000000000E000000000000001
111011011011011011000000000000001
100000000000000000000000000000001
101101101110110110000000000000001
100000000000000000000000000000001
111011011011011011000000000000001
100000000000000000000000000000001
101101101110110110000000000000001
100000000000000000000000000000001
111011011011011011000000000000001
100000000000000000000000000000001
101101101110110110000000000000001
100000000000000000000000000000001
111111111111111111111111111111111