111111111111111111111111111111111
100000000000000000000000000000001
101111011110111101111011110111101
100110C0110C0110C0110C0110C011001
110110101101011010110101101011011
100110001100011000110001100011001
101111011110111101111011110111101
100110C0110C0110C0110C0110C011001
110110101101011010110101101011011
1P00000000000000000000000000000E1
110110101101011010110101101011011
100110C0110C0110C0110C0110C011001
101111011110111101111011110111101
100110001100011000110001100011001
110110101101011010110101101011011
100110C0110C011000110C0110C011001
101111011110111101111011110111101
100000000000000000000000000000001
111111111111111111111111111111111