1111111111111111111
1000000000000000001
1011011011101101101
1000000000000000001
1110110110110110111
1PCCC000000000000E1
1110110110110110111
1000000000000000001
1011011011101101101
1000000000000000001
1111111111111111111