111111111111
1000000C0001
1P0000CCC001
1000000C0E01
111111111111