1111111111111
1P00000000001
1000000E0E0C1
1111111111111