1111111111111
1P00000000001


100000000CE01
1111111111111