11111111111
1P0000000P1
1000000CE01
11111111111