1111111111111
1P000000000C1
100Y00000CE01
1111111111111