1111111111111
1P000000000011
100000000CE01
111111111111111