1111111111111
1P00000010001
1000000E100C1
1111111111111