1111111111111111111
1110110110110110111
1000000000000100P01
1011011011101101101
100000C00000010E001
1111111111111111111