1111111111111
1P00000010001
1000000C100E1
1111111111111