1111111111111
1P00000000001
100000000C001
1111111111111