1111111111111
1000000000001
100000000CE01
1111111111111