11111111111111111
1P0000C010C000001
10110110101101101
10000000000000001
10110101110101101
10000100100100001
10110110001101101
10000100100100001
10110101110101101
10000000000000001
10110110101101101
100000C010C0000E1
11111111111111111