1111111111111111
1P00000000000001
1000000000000001
1000000000000001
1000000C00000001
1000000000000001
1001000000000001
10001000000000E1
1111111111111111