1111111111111111111
1111111111111111111
1100000C010C0000011
1101101101011011011
1100000000000000011
1101101011101011011
1100001001001000011
1P011011000110110E1
1100001001001000011
1101101011101011011
1100000000000000011
1101101101011011011
1100000C010C0000011
1111111111111111111
1111111111111111111